111111111
1C0000C01
1000P0001
1E0000C01
111111111