11111
1E0C1
10P01
1E0C1
1E0C1
10C11
1E0C1
1E0C1
11011
1E0C1
1E0C1
11111