111111111111
1E0C0000C001
10P000000001
1E0C00000001
1E0C00000001
10C100C00001
1E0C0000C001
1E0C00000001
110100000001
1E0C0000C001
1E0C10000001
111111111111