11111111
10000P01
1000E001
1E0C0001
11111111