11111111
10000P01
1000s001
10000001
11111111