11111111
10000P01
1000E001
1C000001
11111111